111111111111
110000001E11
100101001001
110001110101
1011C0000001
1P0010101001
110000001011
111111111111
