1111111111111111
110000100001E011
100110C0110C1001
1100011000111101
1001000110001001
1C110101C1100011
1100010000011001
1001011111001001
1011C1000010C101
1000100010000101
1P100010C1000001
1111111111111111
